able - способный, быть в состоянии
acid - кислота, кислый
angry - сердитый
beautiful - красивый
black - чёрный
boiling - кипение
bright - яркий, умный
broken - сломанный
brown - коричневый
cheap - дешёвый
chemical - химикат
chief - главный
clean - чистый, чистить
clear - ясный, очищать, оправдываться
common - общий
complex - комплекс
conscious - сознательный
cut - резать
deep - глубокий, глубоко
dependent - зависимый
early - рано, ранний
elastic - эластичный
equal - равный, равняться
fat - толстый, жир
fertile - плодородный
first - первый
fixed - неподвижный, неизменный
flat - плоский, квартира, плоскость
free - свобода, бесплатный
frequent - частый, часто посещать
full - полный
general - общий, генерал
good - хороший
great - великий, великолепный
grey|gray - серый
hanging - вывешивание, висение
happy - счастье
hard - трудный, тяжёлый, твёрдый
healthy - здоровый
high - высокий, высоко
hollow - пустота
important - важный
jewel - драгоценный камень
kind - добрый, вид
like - подобный, любить, нравиться
living - проживаниe
long - долго, длинный
male - мужской, мужчина
married - женатый, замужем
material - материал
medical - медицинский
military - военный
natural - натуральный
necessary - необходимый
new - новый
normal - нормальный
open - открытый, открывать
parallel - параллельный, находить что-либо подобное
past - мимо, прошлый
physical - физический
political - политический
poor - бедный, плохой, слабый
possible - возможный
present - существующий, подарок
private - личный, приватный
probable - вероятный
quick - быстрый
quiet - тихий, успокаивать
ready - готовый, готов
read - читать
read - читать
regular - регулярный
responsible - ответственный
right - верный, право
round - вокруг, круглый, раунд
same - то же самое
second - секунда, второй
separate - отдельный, отделять
serious - серьёзный
sharp - острый
smooth - гладкий, мягкий, приглаживать
sticky - липкий
stiff - жесткий
straight - прямой
strong - сильный
sudden - внезапный
sweet - сладкий
tall - высокий
thick - толстый, густой
tight - трудный
tired - усталый
true - правда, правдивый
violent - сильный, жестокий
waiting - ожидание
warm - теплый, нагревать
wet - влажный
wide - широкий
wise - мудрый
yellow - жёлтый
young - молодой
