come - приходить, приезжать
get - получать, заставлять
give - давать
go - ходить, идти
keep - продолжать, держать, оставлять, не допускать
let - позволять
make - делать/сделать, заставлять
put - помещать
seem - казаться, представляться
take - брать/взять
be - быть
do - делать
have - иметь, съесть, знать
say - говорить
see - видеть
send - посылать
may - мочь
will - быть хотеть
about - о
across - через
after - после
against - против
among - среди
at - в
before - перед
between - между
by - к, в соответствии с, за, на
down - вниз
from - из
in - в
off - прочь, от
on - на
over - по
through - через
to - к, до, в
under - под
up - вверх
with - с
as - поскольку, как
for - для
of - из, о, от
till - пока, до
than - чем
a - любой, один, каждый, некий
the
all - все, весь
any - любой, никто
every - каждый
no - никакой, нет
other - другой
some - некоторый, немного
such - такой, таким образом
that - что
this - это, этот
i - я
he - он
you - ты, вы
who - кто
and - и
because - потому что
but - а, но
or - или
if - если
though - хотя
while - в то время как
how - как
when - когда
where - где, куда, откуда
why - почему
again - снова
ever - когда-либо, никогда
far - самый дальний
forward - отправлять, вперед
here - здесь, сюда
near - рядом, около
now - теперь, сейчас
out - вне, снаружи
still - все еще
then - тогда
there - там, туда
together - вместе
well - хорошо, намного
almost - почти
enough - достаточно
even - еще, даже
little - маленький
much - много
not - не
only - только
quite - весьма
so - так
very - очень
tomorrow - завтра
yesterday - вчера
north - север
south - юг
east - восток
west - запад
please - пожалуйста
yes - да 
