awake - активный, пробуждать, просыпаться
bad - плохой
bent - склонность, сгибать
bitter - горький, ожесточенный
blue - синий
certain - уверенный, определенный
cold - холодный
complete - полный, заканчивать
cruel - жестокий
dark - темнота, темный
dead - мёртвый
dear - дорогой
delicate - тонкий, деликатный
different - различный, другой
dirty - грязный
dry - сухой, сушить
false - фальшивый
feeble - слабый
female - женский
foolish - глупый
future - будущий, будущее
green - зелёный
ill - плохо, болеть
last - последний, длиться
late - опаздывать
left - лево, левый
loose - свободный, освобождать
loud - громкий
low - низкий
mixed - перемешанный
narrow - узкий, сужаться
old - старый
opposite - напротив, противоположный
public - публичный
rough - грубый
sad - расстроенный
safe - безопасный
secret - секретный
short - короткий
simple - простой
slow - медленный
small - маленький
soft - мягкий
solid - твёрдый, солидный
special - специальный
strange - странный
thin - худой, тонкий, жидкий
white - белый
wrong - неправильный, несправедливость
